9 8
****#****
*#*&#****
*####**$*
*****##**
**#***#**
****#****
*********
**####**#
